Raesfeld: Raesfeld is a municipality in the district of Borken in the state of North Rhine-Westphalia, Germany.

Flughafen: Airport

Berlin: Berlin is the capital and largest city of Germany by both area and population.

Bratwurst: Bratwurst is a type of German sausage made from pork or, less commonly, beef or veal.

Hauptstrasse: Main Road

Brot: Bread

Klimaanlage: Air Conditioner

Rammstein: lit. "ramming stone"
    1) Rammstein is a German Neue Deutsche HÃ¤rte band formed in Berlin in 1994.
    2) Ramstein Air Base, a US Air Force base near the town
    3) Ramstein (wrestler), the ring name of a Mexican professional wrestler
    
Porsche: Porsche is a German automobile manufacturer specializing in high-performance sports cars, SUVs and sedans
    -The name Porsche may be derived from german, meaning "offering"
     
BMW: The acronym BMW stands for Bayerische Motoren Werke GmbH, which roughly translates to the Bavarian Engine Works Company.

Biergarten: beer garden

Ratskeller: lit. "council's cellar" 
     name in German-speaking countries for a bar or restaurant located in the basement of a city hall (Rathaus) or nearby.
     
Dirndel: A dirndl is a feminine dress which originated in German-speaking areas of the Alps.

Lederhose: leather pants
     Lederhosen are short or knee-length leather breeches that are worn as traditional garments in some regions of German-speaking countries.
     
Schloss: Lock, or building such as a palace or manor

wettbewerbsfaehig: competitive

Mehlhase: ?flour bunny?
    -name for person who's dwelling is on a grassy field or hill

Gebaeck: pastries

Baeckerei: Bakery

Hund: Dog

Doener: Doner, german snack, like a kebab

Apfelkuchen: Apple Cake

Eltz:The House of Eltz was a noted German noble family of the Uradel.
    -originally the name of a river
